####################
#..................#
#########.##########
^^^^#####.##########
^^^^#####.##########
######......########
########.###########
##^^^^^^^^^^^^######
####################
####################
