####################
#..................#
#########.##########
#########.##########
#########.##########
######......########
####################
####################
####################
####################
